spotify=spotify
id=807792310930243644
Liar Mask=liarmask
zero_one=zero_one
Doom Crossing: Eternal Horizons=doomcrossingeternalhorizons
Cyphisonia E.P.=cyphisoniaep
crystallized=crystallized
PLANET//SHAPER=planetshaper
Miracle Milk=miraclemilk
Millennium Mother=millenniummother
DEAD BEATS=deadbeats
Lost In Paradise=lostinparadise
Different World=differentworld
Intrauterine Education=intrauterineeducation
Bu-Ikikaesu=bu-ikikaesu
Overkill=overkill
楽園=rakuen
TVアニメ「ドロヘドロ」EDテーマソングアルバム「混沌の中で踊れ」=dorohedoroed
葛西ハーコーズ2 オールスターズ=cyclehit
Fantastic Magic=fantasticmagic
LANDSPACE=landspace
HOLIDAYS IN THE SUN=holidaysinthesun
FIXION=fixion
UNSER=unser
wizard=wizard
TVアニメ「Re:ゼロから始める異世界生活」2nd seasonエンディングテーマ「Memento」=memento
Wild Side=wildside
Off With Their Heads=offwiththeirheads
Rightfully (TV Animation Goblin Slayer opening)=rightfully
Devil=devil
Neon Genesis Evangelion (Original Series Soundtrack)=nge
カワキヲアメク=kawakiwoameku
Utamonogatari Special Edition (Original Soundtrack)=utamonogatari
porte=porte
MYTH & ROID ベストアルバム「MUSEUM-THE BEST OF MYTH & ROID-」=museum
the WORLD Ruler=theworldruler
アニメ『BNA ビー・エヌ・エー』Complete album=bna
STEAL!!=steal
Hacking to the Gate=hackingtothegate
Big Bang!!!=bigbang
Hello New World=hellonewworld
Magic Time=magictime
eYe's=eyes
Deep In Abyss (Made In Abyss OST)=deepinabyss
